datefmt=ANSI　日付設定
trnrpt=他のトランザクション {0} 他のレポート {1} 他のプロシージャ {2} 他のワークパネル {3} 他のメニュー
mmmainmenu=メインメニュー {0} データベース管理メニュー {1} トランザクション {2} レポート {3} データベース作成 {4} インデックスの再作成 {5} 冗長の再作成 {6} データベースの再編成 {7} アプリケーションエクスポート {8} インタプリタを使う {0}0 プロシージャ {0}1 ワークパネル {0}2 メニュー
mmint=GX メニュー積分器 {0} メニュー
opt=オプション
nomenu=ユーザメニューが有りません
keys=ESC=戻る　F1=ヘルプ
prot=プロトタイプ
prod=プロダクション
idx=データベースインデックスの再作成しますか？
endofproc=処理終了
mmmain=GENEXUS - メニューマネージャ
mmmdlname=モデル名
mmmdldate=作成日
nooptions=このメニューにはオプションが有りません
more='他の
deleinfo=本当に削除しますか?
sltlst=選択リスト
poslst=以下の全て又はいくつかの項目を入力してください", "その後ENTERを押してください.
selopt=以下から選択して「実行（Enter）」を押す。 {0} 備考:
lastrec=これは最後に該当したレコードです
firstrec=これは最初に該当したレコードです
norectobrow=合致するレコードはありません
filecrea={0} {1} テーブルの作成中
fileren={0}の名前を{1}に変更します
dbcrea=データベースを作成中
conftrn=トランザクションを確認しますか?
waschg={0}が変更されました。
tlotitle=Lotus 1-2-3 (tm)へのデータ転送
creaindx={0} インデックスを作成中 ...
recconv=レコードが変換されました
loaddata=データをロード中です
nodelete=削除は許可されていません
inex=該当なし： {0}
inex_browse=. データを表示しますか?
queryok=クエリーの基準は間違いありませんか?
failequal=レコードにアクセスできません
yes=Y
no=N
date=月 {0} 日 {1} 年
conf=データは間違いありませんか(Y/N)?
rtop=帳票をプリンタに送りますか (Y/N)?
rptques=出力
rptsel=画面 SCR;プリンタ PRN;ファイル FIL
printing=印刷中...
canques=プログラムをキャンセルしますか (Y/N)?
canmsg=ユーザの要求によりプログラムはキャンセルされました
wait=続けるにはエンターキーを押してください ...
del=無効な削除、詳しい情報は {0}
delcas=総ての情報を削除：
lock="レコード {0} は別のユーザが使用中です"
flock="テーブル {0} は別のユーザが使用中です"
help=ヘルプ
noupdate=レコードは既に存在しています
noinsert=レコードが見つかりません
chg=変更を廃棄しますか (Y/N)
mlmax="ライン数が超過しました
rgzlcktb={0}.再編成するためにテーブルをロックしています。
rgzdic={0}.参照整合性制約を削除しています。
rgzdropcol=テーブル{0}から項目を削除しています。
1000=警告: リネームが使われていません。ユーザIDは ' {0} 'ではありません。
1001=テーブル {0} からインデックス {1} を削除します。
1002=テーブル {0} を削除します。
1003=テーブル {0} の項目に初期値を設定します。.
1004={0}は既に存在しています。
dropindx={0}インデックスを削除中
outrange={0}範囲以外
graph=グラフ
print=印刷
strdate={0} {1} {2}
runpgm=プログラム{0}実行中。
mbactions=アクション
mbview=ビュー
mbhelp=ヘルプ
mbview_first=最初へ
mbview_last=最後へ
mbview_previous=前へ
mbview_next=次へ
mbview_select=選択
mbhelp_cont=コンテンツ
mbdelete=削除
mbrefresh=再表示
mbclose=終了
mbconfirm=実行（確定させる）
selone=以下から選択して「実行（Enter）」を押す。
selnocor=選択されたメニュのオプションは正しくありません。
cmdandopt=コマンド指定持にメニュオプションは選択できません。
cmdlpmpt=コマンド ===>
deltbl=古いテーブル {0} を削除し新しいテーブルを作ります.
rename=テーブル　{0}　を {1}　に改名中.
confrpt=「実行キー(Enter)」を押して処理を開始して下さい.
nochgmode=要求されたモードに変更できません.
oneselonly=同時に複数項目の選択はできません.
eof=データの始め／終りに到達しました
canctrn=トランザクションがキャンセルされました.
confins=データ挿入中 確認のため「実行キー(Enter)」を押して下さい.
confupd=データ更新中 確認のため「実行キー(Enter)」を押して下さい.
confdel=データ削除中 確認のため「実行キー(Enter)」を押して下さい.
recins=データが追加されました.
recupd=データが更新されました.
recdel=データが削除されました.
notsame=データは同じ {0}.に属していません
faildel=無効な削除、詳しい情報は {0}
noexist={0} は見つかりません
noaccept={0} への変更は無視されました.
failbool={0} は "Y" か "N".以外は無効です
wrongopt=オプションは "4" か スペース 以外は無効です
dupkey=データはすでに別のユーザが追加しました。
noprompt=現在のカーソル位置ではプロンプトが開けません。
spc=選択値を指定してください
tcpe=選択基準を入力し「実行キー(Enter)」を押して下さい.
spv=項目を一覧から選んで下さい
tope=オプションを入力し「実行キー(Enter)」を押して下さい.
oeqs=1=選択
datachg=({0})ユーザにデータが変更されました
icp=カーソルの位置が間違っています.
seloptwrong=オプションは選択できません.
nomnuopt=このメニューにはオプションが有りません
emptylist=(一覧は空です.)
callerr=プログラム {0} 起動エラー
exist={0} は既に存在します
norecrpt=この帳票には該当するデータはありません.
0=実行
enter=処理
cancel=キャンセル
display=表示
insert=追加
update=更新
delete=削除
first=最初へ
next=次へ
previous=前へ
prompt=プロンプト
select=選択
menu=メニューバー
exit=終了
refresh=再表示
retrieve=検索
morekeys=他のキー
badkey=現在このキーは無効です.
faildate={0}は無効な日付／時間です。
nohelp=利用できるヘルプが有りません
lockrcd=他のユーザがデータをロックしています：
readerr=エラー ( {0} ) 処理中
usrcanc=処理がユーザにより終了させられました.
tipe=情報を入力し「実行キー(Enter)」を押して下さい.
actions=アクション
view=ビュー
rgzctnt={0}.一時的と新規テーブルを作成します。
rgzrrpgm={0}.再編成プログラムを実行中。
rgzrnmtbl={0}.テーブル名を変更しています。
rgzbldidx={0}.インデックスと参照整合性制約を作成しています。
rgzdroptbl={0}.項目をドロップしテーブルを削除します。
rgztbllck=テーブル{0}をロックします。
rgzd1c=テーブル{0}から参照整合性制約を削除しています。.
recdeleted=エラー: 他ユーザによってレコードが削除されました。
keynfound=指定されたキーのデータが見つかりません。
unexp=データの更新中不明なエラーが発生しました。やり直してください。
sucadded=データが追加されました
sucupdated=データが更新されました
sucdeleted=データが削除されました
captionadd=追加
captionupdate=更新
captiondelete=削除
captionconfirm=実行（確定させる）
getbeforedlt=レコードを読まなければ削除できません
getbeforeupd=レコードを読まなければ更新できません
mustconfirm=データを確認してください。
confdelete=削除を確認してください。
baddatetime={0}は無効な日付と時間です。
badtime={0}は無効な時間です。
badnum=値は無効な数字です。
nomatch=該当するデータが見つかりませんでした。
pmterr=プロンプトプログラム {0} が見つかりません
refcallerror=参照整合性の参照プログラム {0} が見つかりません
browse=検索
setonlr=Seton Lr
badkeyrfr=現在このキーは無効です(再表示は保留中)
dateoutr={0} は.({1}-{2})の範囲外です.
arrayerror=インデックスが範囲以外です。
callerror=プログラム起動エラー
divideerror=0で割算
numericalerror=数字エラー
fileerror=ファイルエラー。ファイル：
code=コード
index=インデックス
ambiguousck={0} が曖昧です
refinterror=不明な参照整合性エラー
makdsc=メインメニュー
dbcr1=データベース作成
dbcr2=テーブル作成
dbcr3=インデックス作成
dbcr4=データ変換
dbcr5=テーブル改名
dbcr6=モデル更新
dbcrtitle=GeneXus データベース管理
tblcrea=テーブル作成中
idxcrea=インデックス作成中
reocom=再編成完了
delreo=再編成仕様の削除中
creinpro="データベース作成中...
notcrespc=作成仕様は有りません
notreospc=再編成仕様は有りません
asktocre=空のデータベースを本当に作りますか?
creok=データベースが作成されました
asktoreo=デ－タベースを再編成しますか?
reoinpro=モデルの再編成中...
okcapt=はい
genwith=作成済
aboutcapt=バージョン情報
sysinfo=システム情報...
notsysinfo=システム情報は現在使用できません
cnclcapt=キャンセル(&C)
prtready=プリンタの準備はできていますか (Y/N)?
rwait=Enter=実行/継続  Esc=戻る
idate=無効な日付
isdone=完了
nnul=Null は許容されていません
discard=変更（編集）を停止します
logfull=データトランザクションログが一杯です、コミットかロールバックを行ってください
opna=オプションは使用できません
savechanges=変更を反映させますか?
mnuopts=ファイル(&F) {0} 終了(&x) {1} 編集(&E) {2} 切り取り(&t) {3} コピー(&C) {4} 貼り付け {5} 削除(&D) {6} 全て選択(&S) {7} ビュー(&V) {8} 前へ(&P) {0}0 次へ(&N) {0}1 最初へ(&F) {0}2 最後へ(&L) {0}3 ツールバー(&T) {0}4 ステータスバー(&S) {0}5 アクション(&A) {0}6 選択(&S) {0}7 再表示(&R) {0}8 レコード削除(&D) {0}9 ウィンドウ(&W) {1}0 重ねて表示(&C) {1}1 アイコンの配置 {1}2 ヘルプ(&H) {1}3 コンテンツ {1}4 検索(&S)... {1}5 バージョン情報(&A) {1}6 オブジェクト {1}7 拡張 {1}8 全て拡張
newmnuopts=ファイル(&F) {0} 閉じる(&C) {1} 終了(&x) {2} 編集(&E) {3} 切り取り(&t) {4} コピー(&C) {5} 貼り付け {6} 削除(&D) {7} 全て選択(&S) {8} ビュー(&V) {0}0 前へ(&P) {0}1 次へ(&N) {0}2 最初へ(&F) {0}3 最後へ(&L) {0}4 ツールバー(&T) {0}5 ステータスバー(&S) {0}6 アクション(&A) {0}7 選択(&S) {0}8 再表示(&R) {0}9 レコード削除(&D) {1}0 ウィンドウ(&W) {1}1 重ねて表示(&C) {1}2 アイコンの配置 {1}3 ヘルプ(&H) {1}4 コンテンツ {1}5 検索(&S)... {1}6 バージョン情報(&A) {1}7 確認(&C)
invalid_dir={0}は有効なディレクトリではありません
gxws_loadingfrom={0}からロード中です。　
captionaddweb=追加
captionupdateweb=更新
captionconfirmweb=確認
captiondeleteweb=削除
errtitle=エラー
err_details=詳細(&D)
err_quit=終了(&Q)
err_retry=再試行(&R)
err_login_ldap=無効なユーザ／パスワードです
runtimeerr=ランタイムアプリケーション例外
runtimedb=データベースへのアクセス中にエラーが発生しました。
runtimeappsrv=アプリケーションサーバーへのアクセス中にエラーが発生しました。
colordialog=色を選択して下さい
dblogin=サーバーへのログイン
user=ユーザ名
password=パスワード
enteruser=ユーザ名を入力してください
enterpwd=パスワードを入力してください
invaliddate=無効な日付
reportdest=出力先を選択
reportdest_printer=プリンタ
reportdest_screen=画面
reportdest_file=ファイル
button_cancel=キャンセル(&C)
button_ok=&OK
confirmtitle=実行（確定させる）
msgtitle=メッセージ
yestext=はい
notext=いいえ
errconas=アプリケーションサーバ又はデータベースへの接続中にエラーが発生しました
gxdbm=GeneXus データベースマネージャ
gxdbm_reorg=GeneXus データベースマネージャ- 再編成
gxdbm_cpymdl=GeneXus データベースマネージャ - モデルの更新
confirm_cpymdl=GeneXusのモデルの更新が選択されました。よろしいですか?
gxdbm_gxdb=GeneXus データベースマネージャ - GXDB++ 更新
confirmgxdb=GXDB++だけの更新が選択されました。よろしいですか?
noreorg=再編成仕様は有りません。
nosuccess=再編成プログラムの生成がうまくいきませんでした。再試行してください。
confirmreorg=本当に，再編成を実行しますか?
dbnotreorg=データベースは再編成されませんでした。
reorgpref=(プロパティReorganize Server TablesがNoです)
reorgsuccess=再編成が成功しました。
reorgnotsuccess=再編成が失敗しました。
reorgupdgxdb=GXDB++を更新しています ...
reorgrenre=再編成の状態を変更できません
reorgrengx=GXDB++の仕様ファイル名を変更できませんでした
reorgerrupdgxdb=GXDB++クラスを更新しようとしてエラーが発生しました
mnufile=ファイル(&F)
mnuexit=終了(&x)
mnuedit=編集(&E)
mnucut=切り取り(&t)
mnucopy=コピー(&C)
mnupaste=貼り付け
mnudelete=削除(&D)
mnuselectall=全て選択(&S)
mnuview=ビュー(&V)
mnuprev=前へ(&P)
mnunext=次へ(&N)
mnufirst=最初へ(&F)
mnulast=最後へ(&L)
mnutoolbar=ツールバー(&T)
mnustatusbar=ステータスバー(&S)
mnuactions=アクション(&A)
mnuselect=選択(&S)
mnurefresh=再表示(&R)
mnudelrec=レコード削除(&D)
mnuwindow=ウィンドウ(&W)
mnuarrange=上下に並べて表示(&T)
mnucascade=重ねて表示(&C)
mnuhelp=ヘルプ(&H)
mnuindex=コンテンツ
mnusearch=検索(&S)...
mnuabout=バージョン情報(&A)
mnuclose=閉じる(&C)
mnuconfirm=確認(&C)
toolcut=切り取り
toolcopy=コピー
toolpaste=貼り付け
toolrefresh=再表示
toolhelp=ヘルプ
devmenutrn=トランザクション
devmenurpt=レポート
devmenuproc=プロシジャー
devmenuscr=ワークパネル
ids_column=再編成の出力結果
ids_execute=実行
ids_failed=再編成が失敗しました
ids_ok=再編成が完了しました
ids_title=GeneXusの再編成
ids_close=閉じる
ids_noneeded=再編成は不要です
ids_needed=再編成が必要です
ids_run=実行中...
january=1月
february=2月
march=3月
april=4月
may=5月
june=6月
july=7月
august=8月
september=9月
october=10月
november=11月
december=12月
vsltlst=選択リスト
toolcalculator=電卓
toolcalendar=カレンダー
toolbrowsedata=データ表示
toolselectall=全て選択(&S)
tooldelete=削除(&D)
mnu_previous=前へ(&P)
mnu_tile=上下に並べて表示(&T)
mnu_contents=コンテンツ
